FFFFFFFFFFFFFFFFFFFFFFFWFFFFFF
FFFFFFFFFFFFFFFFFFFFFFFWFFFFFF
FFFFFFFFFFFFFFFFFFFFFFFWFFFFFF
FFFFFFFFFFFFFFFWWFFFFFFFFFFFFF
FFFFFFFFFFFFFFFWWFFFFFFFFFWFFF
FFFFFFFFFFFFPFFFFFFFFFFFFFWFFF
WWWWWFFFFFFFFFFFFFFFFFFFFFWWWW
FFFFFFFFFFFFHHHHHHHFFFFFTFFFFF
FFFFFFFFFFFFHHHHHHHFFFFFFFFFFF
FFFFFFFFFFFFFFFFFFFFFFFFFFWHHH
FFFFFFFFFFFFFFFFFFFFFFFFFFWHHH
WWWWWFFFFFFFFFFFFFFFFFFFFFWWWW
FFFFFFFFFFFFFFFFFFFFFFFFFFWFFF
FFFFFFFFFFFFFFFFFFFFFFFFFFFFFF
FFFFFFFFFFFFFFFFFFFFFFFFFFWFFF